7 10
1000000002
1011111110
1010000010
1010131010
1000100010
1110101110
P000100000
6 0