7 17
11111111111111111
10000000000000001
10101011110101101
10121010010100101
101110131101P0101
10000000000100101
11111111111111111
4 12